1111111111
1000P000C1
1110101011
1001000E01
10000010C1
1111111111

