11111111111111111
1000P0000001C00E1
10010010000010101
10101000000001001
10010011111100001
10001001110C11101
100C010C100000001
11111111111111111