1111111111
1CCCPCCC01
111C1C11E1
1CC1CC1C01
1CCCC01CE1
1111111111
